#########
# #   # #
# # # # #
# # # # #
# # # # #
# # # # #
# # # # #
#   #   #
#########